0000000111000110000010001110
0111000111001000011100001110
0111000111000110011100001110
0111000000001000011100000000
00000000000000000000xxxxxxx1
00000111000x0001110000000000
00000111000x0001110000000000
00000111000x0001110000000000
00000000000x0000000000000000
1110000000000000000000000111
1110000000000000000000000111
1110000000000000000000000111